XX   XX   XX
  XXX  XXX
XX   XX   XX
XX   XX   XX
  XXX  XXX
XX   XX   XX